promote (v): 
	quảng cáo - advertise
	thăng chức
	cải thiện - improve, enhance, boost
Doanh thu: revenue, income, proceeds, earnings, profit, pay, salary, wages
glass: thủy tinh
departmant (n): phòng ban = division
effective (adj): hiệu quả = effeciect(adj)
unit(n): đơn vị 
quarter: 1 phần tư, quý
take time off: nghỉ việc, nghỉ lễ nghỉ phép
mặc dù: although, even though, though
beverage: đồ uống
product launch: khai trương sản phẩm, phát hành sản phẩm
launch (n, v): khai trương tung ra
example = sample: mẫu thử, ví dụ
individual (n): cá nhân
appointment: cuộc hẹn
make an appointment (v): lên lịch hẹn - (make -> schedule, plan, arrange, set up)
loại bỏ: eliminate, delete, remove, discard, get red of, dispose of (v)
artificial (adj): nhân tạo
preservative: chất bảo quản
announce: (v) thông báo
mấy cái cụm bằng nghĩa với many: a range of, avarity of
material (n): tài liệu nguyên vật liệu
sensitive: (adj) nhạy cảm
courier: (n) chuyển phát nhanh

periodically(adv): định kỳ
reluctantly(adv): miễn cưỡng
simultaneously(adv): đồng thời, cùng 1 lúc
overlook(v): bỏ qua, bỏ nhỡ, bỏ sót
communications: thông tin giao tiếp

expectation (n): kỳ vọng, mong đợi
surpassed = exceed (v): vượt qua
invest: đầu tư
progress: tiến triển

attribute O to Np: cho rằng cái này là do nguyên nhân này
impressive (adj): ấn tượng
factor: (n): nhân tố
case: (n): trường hợp, ốp vỏ, bọc
vỏ bọc: shell = case
consider: coi như, xem xét
available (adj): tính có sẵn
ensure: (v) đảm bảo
durability: (adv): tính bền

brightness: (n) độ sáng
adaptive (adj): thích ứng, thích nghi 
temperature (n): nhiệt độ
characteristic: đặc trưng
